XXXXXXXXXXXxXXXXXXXxXXXXXX
X                        X
X                    XHHHX
                     H   X
X                    H K X
XXXXXXXXXXXXXXXXXXXXXXXXXX
