XXXXX XXXXXXXXXX
X        <     X
X  XHHX  XHXHX X
Y  X  X    H   X
X  XHHX  XHXHX X
X         >    X
X  X   XXX     X
X   X    X      
X              X
XXXXXXXX XXXXXXX
