     XXXXXXXXXXXXXXXXX
     X       X       X
     X       X       X
XXXXXXXXXXXxXXXXXXX XXXXXX
X     <                  X
X                    XHHHX
                     H   X
X                    H   X
XXXXXXXXXXXXXXXXXXXXXXXXXX
